NO  textures/textwall_v2.xpm
SO  textures/textwall_v2.xpm
WE  textures/textwall_v2.xpm
EA  textures/textwall_v2.xpm
F   40,10,10
C   100,60,40
1111111111111111111111111111111111111111111111111
1000000000000000001000000000000000000000000001
100000000000000000100111111111111100011000110111
1001001001001001001001100000000010000000000000011111111111111111111
1000000000000000001001100111110011111110111111011110000000000000001
10000000000000000010011001111100000000000001100111101111111111111011111111111111111111111111111111111111111111111111111111111111111111111111111111111
10010010010010010010000001111100001001001101101111101110000000000000000000000000000000000000000000000000000000000000000000000000000000000000000000001
10000000000000000010000001111100000000001001100111101110000000000000000000000000000000000000000000000000000000000000000000000000000000000000000000001
10000000000000000000000001111100000000001001110111100010000000000000000000000000000000000000000000000000000000000000000000000000000000000000000000001
100100100100100100000E0001111100001001001001110111111010000000000000000000000000000000000000000000000000000000000000000000000000000000000000000000001
10000000000000000000000000000100000000001001110111111010000000000000000000000000000000000000000000000000000000000000000000000000000000000000000000001
10000000000000000010000000000100000000001001110111111010000000000000000000000000000000000000000000000000000000000000000000000000000000000000000000001
10010010010010010010001111111111111111111001110000000010000000000000000000000000000000000000000000000000000000000000000000000000000000000000000000001
10000000000000000010001001000100000000000001111111111110000000000000000000000000000000000000000000000000000000000000000000000000000000000000000000001
10000000000000000010000000000111000000000001111111111111111111111111111111111111111111111111111111111111111111111111111111111111111111111111111111111
10010010010010010010000000000111100000000001
11000000000000000010110110110100000000000011
10000000000000000010000000000111000000000011
11111111111111110011111111111100000000011111
11111111111111110000001111111100111111111111
              111111100000000001111111111111
             11111111111111111111111111111111