
NO  textures/textwall_v2.xpm
SO  textures/textwall_v2.xpm
WE  textures/textwall_v2.xpm
EA  textures/textwall_v2.xpm

F   40,10,10
C   textures/ceiling.xpm

111111
101001
10W101
100001
100001
111111
