11111111111111111111111111111111111111111111111111111111111
10000000000000000000000000000001111111111111111110000000001
10000000000000000000000000000111111111111111111111111110001
10001111111111111111000000000111111111111111111111111110001
10001111111111111111000000000111111111111111100000000000001
10001111111111111111000000000111111111111111100000000000001
10001110000000000111000000000111111111111111100000000000001
10000000000000000000000000000000000000000000000000000000001
10000000000000000000000000000000000000000000000000000000001
1000000000000000000000000N0000000000000000000000000000000011111111111111111111111
100000000000000000000000000000000000000000000000000000000000000000000000000000001
100000000000000000000000000000000000000000000000000000000000000000000000000000001
111111111111111111100000001111111111111111111111111111111111111111111110000000001
111111111111100000000000000000001111100000000000000000000000000000000000000000001
111111111111100000000000000000001111100000000000000000000000000000000000000000001
111111111111100000000000000000001111100011100011100011100011100011100011100011101
111111111111100000000000001111111111100000000000000000000000000000000000000000011
111111111111111111111111111111111111111111111111111111111111111111111111111111111