NO  textures/textwall_v2.xpm
SO  textures/textwall_v2.xpm
WE  textures/textwall_v2.xpm
EA  textures/textwall_v2.xpm
F   40,10,10
C   255,30,59

11111111111111111111111
10000000001000000000001
11110111101011111110111
100001010110000010001
101111000000111110111
10000001011S000000001
101111010111111111101
101100010111111000001
100001110000111101111
101100000110000000001
111111110000111111111
111111111111111111111