NO  textures/textwall_v2.xpm
SO  textures/textwall_v2.xpm
WE  textures/textwall_v2.xpm
EA  textures/textwall_v2.xpm
F   40,10,10
C   textures/ceiling.xpm

111111111
100000001
100000011
111111N11
111111111
