peorj iperj wierj e
weyr ey 



e ywer ywer


1111111
1000001
1111001
   1001
   1001
   1001
1111001
1000001
100000111111
100000000001
111111111111




