peorj iperj wierj e
weyr ey 



e ywer ywer



1
1
1111111                   11111111
1000001111                10000001
1111101001                10000001
   1001001111             11111111
   100111100011
   1000000N001
1111001111111
10000000000111
10000011111101
10000000000101
11111111111111
1


df 
fdfg df
