NO  textures/textwall_v2.xpm
SO  textures/textwall_v2.xpm
WE  textures/textwall_v2.xpm
EA  textures/textwall_v2.xpm
F   40,10,10
C   textures/ceiling.xpm




11111111111111111111111111111111
10000000000000111111111100000001
10000111000000000000111100000001
10000000000000000000000000000001
11111100000000000000000000000111
11111111110N00000000000000000111
11111111110000000000000010000111
11111111111111111000000010000111
11111111111111111000000000000111
11111100000000000000000000001111
11111100000000000000000011111111
11111111111111111111111111111111